D5553D5513
9513C3956A
E96C3C6D52
92F96BFFFA
AAFC5057FA
AEFFFAFFFA
A953FAFD52
847AFEFFFA
AB9695393A
C6C547C6C6

1,1
5,5
EESESWSEES